15
10
1111111111111111111111111111111111
1000000000000000000000000000000001
1010111111111111100111111111110101
1010100001000000100001000000010101
1011101111111110111001011111010101
1000001000000010001001000100010101
1011101111111011101001110111011101
1011101111111011101001110111011101
1010101000001010001001010001000101
1010111011111010111001011101110101
1010000010000010100000000101000101
1010111110101110111111111101011101
1010100000101000000000000001010001
1010101011101111111111011111010101
1010101010100000000001010001010101
1010101010111110111111010111011101
1010101010100010100000000100000101
1010101010101110111111110111110101
1000101010101000000000010000010101
1011101110101111111001110111110101
1010000000100000000001000100010101
1010111110111011111101110101110101
1010100010001010000100010101000101
1011101110111010100111011101110101
1010001000101010100001010000010101
1010111011101010111101110111010101
1010100010100010000100000101000101
1010101110111011100111011101111101
1000100000101000100101010000000001
1000100000101000100101010000000001
1011101110101111111101010111110101
1010001010000000000000010100010101
101111101111111111111101110111111e
0000000000s00000000000000000000100
0000000000000000000000000000000000